000000000
000000000
003333000
000103000
000003000
333333200
000000000
000000000